##############################....................###############################...............................................................................
##############################....................###############################...............................................................................
##############################....................###############################...............................................................................
##############################....................###############################...............................................................................
##############################....................###############################...............................................................................
##############################....................###############################...............................................................................
##############################....................###############################..............................#....................#...........................
##############################....................###############################..............................#....................#...........................
##############################....................###############################..............................#....................#...........................
...............................................................................................................#....................#...........................
...............................................................................................................#....................#...........................
...............................................................................................................#....................#...........................
...............................................................................................................#....................#...........................
...............................................................................................................#....................#...........................
...............................................................................................................#....................#...........................
...............................................................................................................#....................#...........................
##############################....................###############################..............................#....................#...........................
##############################....................###############################..............................#....................#...........................
##############################....................###############################..............................#....................#...........................
##############################....................###############################...............................................................................
##############################....................###############################...............................................................................
##############################....................###############################...............................................................................
##############################....................###############################...............................................................................
##############################....................###############################...............................................................................
##############################....................##############################................................................................................
................................................................................................................................................................
................................................................................................................................................................
................................................................................................................................................................
................................................................................................................................................................
................................................................................................................................................................
................................................................................................................................................................
.....................................................................................................###.....................###..................###...........
.....................................................................................................###.....................###..................###...........
.....................................................................................................###.....................###..................###...........
.....................................@...............................................................###.....................###..................###...........
.....................................................................................................###.....................###..................###...........
.....................................................................................................###.....................###..................###...........
.....................................................................................................###.....................###..................###...........
................................................................................................................................................................
................................................................................................................................................................
................................................................................................................................................................
................................................................................................................................................................
................................................................................................................................................................
................................................................................................................................................................
................................................................................................................................................................
................................................................................................................................................................
................................................................................................................................................................
................................................................................................................................................................