##############################....................##############################
##############################....................##############################
##############################....................##############################
##############################....................##############################
##############################....................##############################
##############################....................##############################
##############################....................##############################
##############################....................##############################
##############################....................##############################
...............................................................................#
...............................................................................#
...............................................................................#
.......................................@.......................................#
...............................................................................#
...............................................................................#
...............................................................................#
##############################....................##############################
##############################....................##############################
##############################....................##############################
##############################....................##############################
##############################....................##############################
##############################....................##############################
##############################....................##############################
##############################....................##############################
................................................................................
................................................................................
................................................................................
................................................................................
................................................................................
................................................................................
................................................................................
................................................................................
................................................................................
................................................................................
................................................................................
................................................................................
................................................................................
................................................................................
................................................................................
................................................................................
................................................................................
................................................................................
................................................................................
................................................................................
................................................................................
................................................................................
................................................................................
................................................................................
