################################################################################################################################
#..............................................................##..............................................................#
#..............................................................##..............................................................#
#..............................................................##..............................................................#
#...........######.......................############..........##..............................................................#
#...........######.......................############..........##.........................###########..........................#
#...........######.......................############..........##........................#.....#.....#.........................#
#...........######.......................############..........##.......................#......#......#........................#
#...........######.....................................................................#.......#.......#.......................#
#...........######..............g...................................@..................#################.......................#
#......................................................................................#.......#.......#.......................#
#................................#############..........................................#.....#.#.....#........................#
#................................#############.................##........................#...#...#...#.........................#
#................................#############.................##.........................#.#.....#.#..........................#
#................................#############.................##..........................#########...........................#
#................................#############.................##..............................................................#
#..............................................................##..............................................................#
#..............................................................##..............................................................#
#..............................................................##..............................................................#
#############################....#######################################################..............##########################
#############################....#######################################################..............##########################
#..............................................................##..............................................................#
#..............................................................##..............................................................#
#..............................................................##..............................................................#
#.........#....................................................##..............................................................#
#.........#....................................................##..............................................................#
#.........#....................................................##..............................................................#
#.........#....................................................................................................................#
#.........#.....................................................................................................................
#.........#.....................................................................................................................
#.........#.....................................................................................................................
#.........#.....................................................................................................................
#.........#....................................................................................................................#
#.........#....................................................##..............................................................#
#.........####################.................................##..............................................................#
#..............................................................##..............................................................#
#..............................................................##..............................................................#
#..............................................................##..............................................................#
#..............................................................##..............................................................#
#############################....############################################################............#######################